1 2 1 1 1 1 1 1 1 1 1 1 1 1 1 1 1 1 1 1 1 1 1 1
1 0 0 1 0 1 0 0 0 0 0 0 0 0 0 0 0 0 0 0 0 0 0 1
1 0 0 0 0 1 0 0 0 0 0 0 0 0 1 0 0 0 0 0 0 0 0 1
1 1 0 1 0 1 0 0 0 0 0 0 0 0 1 1 1 1 1 1 1 1 0 1
1 1 0 1 1 1 0 0 0 0 0 0 0 0 1 0 0 0 0 0 0 0 0 1
1 1 0 0 0 0 1 0 0 0 0 0 0 0 1 0 1 1 1 1 1 1 1 1
1 1 0 0 0 0 1 0 0 0 0 0 0 0 1 0 0 0 1 0 0 0 0 1
1 1 0 1 0 1 0 0 0 0 0 0 0 0 1 0 0 0 1 0 0 1 0 1
1 0 0 0 0 1 0 0 1 1 0 1 1 0 1 0 0 0 1 0 0 0 0 1
1 0 1 0 0 1 0 0 1 0 0 0 1 0 1 0 0 0 1 0 1 0 0 1
1 0 1 1 0 1 0 0 1 0 0 0 1 0 1 0 0 0 1 0 0 0 0 1
1 0 0 0 0 1 0 0 1 0 0 0 1 0 1 0 0 0 0 0 0 0 0 1
1 1 1 1 0 1 0 0 1 1 2 1 1 0 1 0 1 0 1 0 1 0 0 1
1 0 0 0 0 1 0 0 0 0 1 0 0 0 1 0 0 0 0 0 0 0 0 1
1 1 1 0 1 0 0 0 1 1 1 1 1 0 1 0 1 1 0 0 1 0 0 1
1 0 0 0 0 0 0 0 1 0 0 0 0 0 0 0 0 0 0 0 0 0 0 1
1 1 1 1 1 1 1 1 1 0 1 1 1 1 1 1 1 1 1 1 1 1 1 1
1 1 0 1 0 0 0 0 1 0 1 0 0 0 0 0 4 5 5 6 5 6 5 1
1 1 0 0 0 0 3 0 1 0 1 0 0 1 4 0 4 5 0 0 0 0 5 1
1 1 0 1 0 0 0 0 1 0 0 0 0 1 4 0 4 5 0 0 0 0 5 1
1 1 0 1 1 1 1 1 1 0 1 0 0 1 4 0 4 5 0 0 0 0 5 1
1 1 0 0 0 0 0 0 0 0 1 0 0 1 4 0 4 5 0 0 0 0 5 1
1 1 1 1 1 1 1 1 1 2 1 0 0 1 4 0 0 0 0 5 5 5 5 1
1 1 1 1 1 1 1 1 1 1 1 1 1 1 1 4 4 4 4 1 1 1 1 1